0 0 2 1 2 2 2
0 0 1 3 5 4 3
1 1 1 1 6 1 1
5 5 4 3 2 3 4
0 2 1 3 6 1 1
3 0 5 4 5 3 2
0 2 1 3 4 0 0